# id: stair_test
# cell: 2.0
# layer_height: 4.0
# open: W,E

layer 0
########
#P.....#
.......#
#.....S#
#.....S#
#.....S#
#.......
########

layer 1
########
#      #
#......#
#..... #
#..... #
#..... #
#......#
########
