# id: undercroft
# cell: 2.0
# layer_height: 4.0
# open: N,E,S,W,U

layer 0
######....##########
#..................#
#..................#
...................#
#..................#
#.^................#
#.^.................
#.^................#
#.^................#
######....##########
